{
  "name": "A Masmorra Negra - Versão Expandida",
  "grid": [
    [1,0,0,0,2,2,2,2,0,0,0,4,2,2,1],
    [6,2,2,0,0,0,2,0,0,2,2,2,0,0,0],
    [0,4,0,0,2,2,2,2,2,0,0,2,0,0,0],
    [0,2,0,2,0,0,0,0,2,0,0,2,0,0,0],
    [0,2,2,2,2,0,0,0,2,2,2,2,2,0,0],
    [2,2,0,0,2,2,2,2,2,0,0,0,2,2,0],
    [2,0,0,0,0,0,2,0,0,0,0,0,0,2,0],
    [2,2,2,2,2,2,2,9,2,2,2,2,2,2,2],
    [0,0,0,0,0,0,2,0,0,0,0,0,0,0,0],
    [0,2,2,2,0,0,2,0,2,2,2,0,2,2,0],
    [0,2,0,2,0,0,2,0,0,0,2,0,2,0,0],
    [0,2,0,2,2,2,2,2,2,0,2,2,2,0,0],
    [0,2,0,0,0,0,0,0,2,0,0,0,2,0,0],
    [0,4,2,2,2,2,2,0,2,2,2,4,2,2,0],
    [1,2,0,0,0,2,2,2,2,0,0,0,0,2,1]
  ],
  "locked": [
    { "roomA": "4-0", "roomB": "5-0" }
  ],
  "levers": [
    {
      "roomId": "0-1",
      "id": "AlavancaDourada",
      "doorRoomA": "4-0",
      "doorRoomB": "5-0"
    }
  ]
}