{
  "name": "A Corrida explosiva",
  "grid": [
    [1, 2, 2, 3, 2, 2, 2, 4, 2, 2, 2, 2, 2, 3, 2, 2, 2, 4, 2, 1],
    [2, 0, 0, 0, 0, 0, 0, 0, 0, 0, 0, 0, 0, 0, 0, 0, 0, 0, 0, 2],
    [2, 0, 5, 2, 2, 2, 2, 2, 2, 2, 2, 2, 2, 2, 2, 2, 2, 5, 0, 2],
    [3, 6, 2, 0, 0, 0, 0, 0, 0, 0, 0, 0, 0, 0, 0, 0, 0, 2, 0, 3],
    [2, 0, 2, 0, 2, 2, 2, 2, 2, 2, 2, 2, 2, 2, 2, 2, 0, 2, 0, 2],
    [2, 0, 2, 0, 2, 0, 0, 0, 0, 0, 0, 0, 0, 0, 0, 2, 0, 2, 0, 2],
    [4, 0, 2, 0, 2, 0, 2, 2, 2, 3, 2, 2, 2, 2, 0, 2, 0, 2, 0, 4],
    [2, 0, 2, 0, 2, 0, 2, 0, 0, 0, 0, 0, 0, 2, 0, 2, 0, 2, 0, 2],
    [2, 0, 2, 0, 2, 0, 3, 0, 9, 2, 5, 2, 0, 2, 0, 2, 0, 2, 0, 2],
    [2, 0, 2, 0, 2, 0, 2, 0, 2, 0, 0, 2, 0, 4, 0, 2, 0, 2, 0, 2],
    [2, 0, 2, 0, 2, 0, 2, 0, 2, 0, 0, 2, 0, 2, 0, 2, 0, 2, 0, 2],
    [2, 0, 2, 0, 2, 0, 2, 0, 2, 0, 0, 2, 0, 2, 0, 2, 0, 2, 0, 2],
    [3, 0, 2, 0, 2, 0, 2, 0, 2, 0, 0, 2, 0, 2, 0, 2, 0, 2, 0, 3],
    [2, 0, 2, 0, 2, 0, 2, 2, 2, 0, 0, 2, 2, 2, 0, 2, 0, 2, 0, 2],
    [2, 0, 2, 0, 2, 0, 0, 0, 0, 0, 0, 0, 0, 0, 0, 2, 0, 2, 0, 2],
    [4, 0, 2, 0, 2, 2, 2, 2, 2, 2, 2, 2, 2, 2, 2, 2, 0, 2, 0, 4],
    [2, 0, 2, 0, 0, 0, 0, 0, 0, 0, 0, 0, 0, 0, 0, 0, 0, 2, 0, 2],
    [2, 0, 2, 2, 2, 2, 2, 2, 2, 2, 2, 2, 2, 2, 2, 2, 2, 2, 0, 2],
    [2, 0, 0, 0, 0, 0, 0, 0, 0, 0, 0, 0, 0, 0, 0, 0, 0, 0, 0, 2],
    [1, 2, 2, 3, 2, 2, 2, 4, 2, 2, 2, 2, 2, 3, 2, 2, 2, 4, 2, 1]
  ],
  "locked": [
    { "roomA": "8-6", "roomB": "8-8" }
  ],
  "levers": [
    {
      "roomId": "19-0",
      "id": "PortaoInterior",
      "doorRoomA": "8-6",
      "doorRoomB": "8-8"
    }
  ]
}
