{
  "name": "A Corrida explosiva",
  "grid": [
    [1, 2, 2, 3, 2, 5, 2, 4, 2, 2, 6, 2, 2, 3, 2, 5, 2, 4, 2, 1],
    [2, 0, 0, 0, 0, 0, 0, 0, 0, 0, 0, 0, 0, 0, 0, 0, 0, 0, 0, 2],
    [2, 0, 5, 2, 2, 4, 2, 2, 2, 3, 2, 2, 2, 2, 2, 4, 2, 5, 0, 2],
    [3, 2, 2, 0, 0, 0, 0, 0, 0, 0, 2, 0, 0, 0, 0, 0, 0, 2, 0, 3],
    [2, 0, 2, 0, 6, 2, 2, 2, 2, 2, 2, 3, 2, 4, 2, 5, 0, 2, 0, 2],
    [2, 0, 2, 0, 2, 0, 0, 0, 0, 0, 0, 0, 0, 0, 0, 2, 0, 2, 0, 2],
    [4, 0, 2, 0, 5, 0, 4, 2, 2, 3, 2, 2, 2, 4, 0, 3, 0, 3, 0, 4],
    [2, 0, 6, 0, 2, 0, 2, 0, 0, 0, 0, 0, 0, 2, 0, 2, 0, 2, 0, 2],
    [2, 0, 2, 0, 4, 0, 3, 0, 9, 2, 5, 2, 0, 2, 0, 4, 0, 2, 0, 2],
    [5, 0, 2, 0, 2, 0, 2, 0, 2, 0, 0, 2, 0, 4, 0, 2, 0, 4, 0, 5],
    [2, 0, 2, 0, 3, 2, 2, 0, 2, 0, 0, 2, 0, 2, 2, 5, 0, 2, 0, 2],
    [2, 0, 2, 0, 2, 0, 2, 0, 2, 0, 0, 2, 0, 2, 0, 2, 0, 6, 0, 2],
    [3, 0, 5, 0, 5, 0, 2, 0, 2, 0, 0, 2, 0, 2, 0, 3, 0, 2, 0, 3],
    [2, 0, 2, 0, 2, 0, 4, 2, 5, 0, 0, 5, 2, 4, 0, 2, 0, 2, 0, 2],
    [2, 0, 2, 0, 4, 0, 0, 0, 0, 0, 0, 0, 0, 0, 0, 4, 0, 5, 0, 2],
    [4, 0, 4, 0, 2, 3, 2, 5, 2, 4, 2, 3, 2, 5, 2, 6, 0, 2, 0, 4],
    [2, 0, 2, 0, 0, 0, 0, 0, 0, 2, 0, 0, 0, 0, 0, 0, 0, 3, 2, 2],
    [2, 0, 2, 2, 3, 2, 2, 4, 2, 2, 5, 2, 2, 3, 2, 2, 4, 2, 0, 2],
    [2, 0, 0, 0, 0, 0, 0, 0, 0, 0, 0, 0, 0, 0, 0, 0, 0, 0, 0, 2],
    [1, 2, 2, 3, 2, 5, 2, 4, 2, 6, 2, 2, 2, 3, 2, 5, 2, 4, 2, 1]
  ],
  "locked": [
    { "roomA": "1-3", "roomB": "2-3" },
    { "roomA": "18-16" , "roomB": "17-16"},
    { "roomA": "10-3", "roomB": "10-4"},
    { "roomA": "9-17", "roomB": "9-16"},
    { "roomA": "5-10", "roomB": "6-10"},
    { "roomA": "15-10", "roomB": "14-10"}

  ],
  "levers": [
    {
      "roomId": "9-19",
      "id": "Alavanca inferior",
      "doorRoomA": "1-3",
      "doorRoomB": "2-3"
    },
    {
      "roomId": "10-0",
      "id": "Alavanca superior",
      "doorRoomA": "18-16",
      "doorRoomB": "17-16"
    },
    {
      "roomId": "2-7",
      "id": "Alavanca esquerda",
      "doorRoomA": "10-3",
      "doorRoomB": "10-4"
    },
    {
      "roomId": "17-11",
      "id": "Alavanca direita",
      "doorRoomA": "9-17",
      "doorRoomB": "9-16"
    },
    {
      "roomId": "4-4",
      "id": "Alavanca diagonal 1",
      "doorRoomA": "15-10",
      "doorRoomB": "14-10"
    },
    {
      "roomId": "15-15",
      "id": "Alavanca diagonal 2",
      "doorRoomA": "5-10",
      "doorRoomB": "6-10"
    }
  ]
}
