{
  "name": "Mapa ",
  "grid": [
    [1, 2, 2, 0, 5, 2, 2, 2, 0, 2, 2, 0, 2, 2, 2, 5, 2, 2, 2, 1],
    [2, 0, 6, 0, 2, 0, 0, 2, 0, 6, 0, 2, 0, 0, 2, 0, 6, 0, 0, 2],
    [2, 0, 3, 2, 2, 0, 2, 2, 2, 2, 2, 2, 2, 0, 2, 2, 3, 0, 2, 2],
    [0, 0, 0, 0, 2, 0, 2, 0, 0, 2, 0, 0, 2, 0, 2, 0, 0, 0, 0, 0],
    [5, 2, 2, 2, 2, 2, 2, 0, 4, 2, 4, 0, 2, 2, 2, 2, 2, 2, 2, 5],
    [2, 0, 0, 0, 0, 0, 3, 0, 0, 2, 0, 0, 3, 0, 0, 0, 0, 0, 0, 2],
    [2, 2, 2, 0, 2, 2, 2, 0, 2, 2, 2, 0, 2, 2, 2, 0, 2, 2, 2, 2],
    [2, 0, 2, 0, 2, 0, 0, 0, 2, 0, 2, 0, 0, 0, 2, 0, 2, 0, 0, 2],
    [0, 0, 2, 0, 4, 0, 2, 2, 2, 2, 2, 2, 2, 0, 4, 0, 2, 0, 0, 0],
    [2, 2, 2, 2, 2, 2, 2, 0, 2, 9, 2, 0, 2, 2, 2, 2, 2, 2, 2, 2],
    [2, 2, 0, 0, 4, 0, 2, 0, 2, 2, 2, 0, 2, 0, 4, 0, 0, 0, 2, 2],
    [2, 0, 0, 2, 2, 2, 2, 2, 2, 0, 2, 2, 2, 2, 2, 2, 0, 0, 2, 2],
    [2, 2, 2, 0, 2, 0, 0, 0, 0, 2, 0, 0, 0, 0, 2, 0, 2, 2, 2, 2],
    [0, 0, 3, 0, 2, 0, 2, 2, 2, 2, 2, 2, 2, 0, 2, 0, 3, 0, 0, 0],
    [5, 2, 2, 2, 2, 2, 2, 0, 4, 2, 4, 0, 2, 2, 2, 2, 2, 2, 2, 5],
    [2, 0, 0, 0, 0, 0, 2, 0, 0, 2, 0, 0, 2, 0, 0, 0, 0, 0, 0, 2],
    [2, 2, 2, 0, 2, 2, 3, 0, 2, 2, 2, 0, 3, 2, 2, 0, 2, 2, 2, 2],
    [2, 0, 0, 0, 2, 0, 0, 0, 0, 6, 0, 0, 0, 0, 2, 0, 0, 0, 0, 2],
    [2, 0, 6, 2, 2, 0, 5, 2, 2, 2, 2, 2, 5, 0, 2, 2, 2, 0, 2, 2],
    [1, 2, 2, 0, 2, 2, 2, 2, 0, 2, 0, 2, 2, 2, 2, 0, 2, 2, 2, 1]
  ],
  "locked": [
    { "roomA": "8-9", "roomB": "9-9" },
    { "roomA": "10-9", "roomB": "9-9" },
    { "roomA": "9-8", "roomB": "9-9" },
    { "roomA": "9-10", "roomB": "9-9" },
    { "roomA": "10-10", "roomB": "9-10" }
  ],
  "levers": [
    {
      "roomId": "9-1",
      "id": "AlavancaCima",
      "doorRoomA": "8-9",
      "doorRoomB": "9-9"
    },
    {
      "roomId": "9-17",
      "id": "AlavancaSul",
      "doorRoomA": "10-10",
      "doorRoomB": "9-10"
    },
    {
      "roomId": "2-1",
      "id": "AlavancaOeste",
      "doorRoomA": "9-8",
      "doorRoomB": "9-9"
    },
    {
      "roomId": "16-1",
      "id": "AlavancaEste",
      "doorRoomA": "10-9",
      "doorRoomB": "9-9"
    },
    {
      "roomId": "2-18",
      "id": "AlavancaInferior",
      "doorRoomA": "9-10",
      "doorRoomB": "9-9"
    }
  ]
}