{
  "name": "Labirinto Gélido",
  "grid": [
    [1,2,4,2,2,2,5,2,4,2,0,2,2,2,5,2,2,2,2,1],
    [2,0,0,0,0,2,0,0,2,0,0,2,0,0,2,0,0,0,0,2],
    [3,0,3,2,2,2,4,0,2,2,2,3,0,2,2,5,3,0,2,2],
    [2,0,0,0,0,0,2,0,0,6,0,0,2,0,0,0,0,0,0,2],
    [5,2,2,4,2,0,3,2,4,2,4,2,2,0,2,2,2,4,2,5],
    [2,0,0,0,5,0,3,0,0,2,0,0,3,0,2,0,0,0,0,2],
    [2,2,6,0,2,2,2,0,2,3,2,0,2,3,2,0,6,2,2,2],
    [2,0,2,0,0,0,2,0,2,0,2,0,2,0,0,0,2,0,2,2],
    [2,0,2,2,4,0,2,2,2,9,2,2,2,0,2,2,2,0,2,2],
    [2,0,0,0,2,0,0,0,2,0,0,2,0,0,2,0,0,0,2,2],
    [2,2,3,0,2,3,2,0,2,3,2,0,2,2,4,0,2,5,2,2],
    [2,0,0,0,0,0,2,0,0,2,0,0,2,0,0,0,0,0,2,2],
    [2,0,2,2,2,0,2,2,2,0,2,2,2,0,2,4,2,0,3,2],
    [0,0,3,0,2,0,3,0,0,2,0,0,3,0,2,0,3,0,0,0],
    [5,2,2,2,4,2,2,0,4,2,4,0,2,2,4,2,2,3,2,5],
    [2,0,0,0,0,0,2,0,0,2,0,0,2,0,0,0,0,0,0,2],
    [2,2,2,0,2,2,3,0,2,2,2,0,3,2,2,0,2,3,2,2],
    [2,0,0,0,2,0,0,0,0,6,0,0,0,0,2,0,0,0,0,2],
    [2,0,2,3,2,0,5,2,2,2,3,2,5,0,4,2,2,0,2,2],
    [1,2,2,0,2,2,4,2,0,2,0,4,2,2,2,0,2,2,2,1]
  ],
  "locked": [
    { "roomA": "8-8", "roomB": "9-8" },
    { "roomA": "10-8", "roomB": "9-8" },
    { "roomA": "3-0", "roomB": "4-0" },
    { "roomA": "16-0", "roomB": "15-0" }
  ],
  "levers": [
    {
      "roomId": "9-3",
      "id": "Alavanca Superior",
      "doorRoomA": "8-8",
      "doorRoomB": "9-8"
    },
    {
      "roomId": "17-9",
      "id": "Alavanca Inferior",
      "doorRoomA": "10-8",
      "doorRoomB": "9-8"
    },
    {
      "roomId": "2-6",
      "id": "Alavanca Superior Esquerdo",
      "doorRoomA": "3-0",
      "doorRoomB": "4-0"
    },
    {
      "roomId": "16-6",
      "id": "Alavanca Superior Direito",
      "doorRoomA": "16-0",
      "doorRoomB": "15-0"
    }
  ]
}
