{
  "name": "Labirinto Gélido",
  "grid": [
    [1,2,2,2,0,2,5,2,2,2,0,2,2,2,5,2,0,2,2,1],
    [2,0,0,0,0,2,0,0,2,0,0,2,0,0,2,0,0,0,0,2],
    [2,0,3,2,2,2,2,0,2,2,2,2,0,2,2,2,3,0,2,2],
    [2,0,0,0,0,0,2,0,0,6,0,0,2,0,0,0,0,0,0,2],
    [5,2,2,2,2,0,2,2,4,2,4,2,2,0,2,2,2,2,2,5],
    [2,0,0,0,2,0,3,0,0,2,0,0,3,0,2,0,0,0,0,2],
    [2,2,2,0,2,2,2,0,2,2,2,0,2,2,2,0,2,2,2,2],
    [2,0,2,0,0,0,2,0,2,0,2,0,2,0,0,0,2,0,2,2],
    [2,0,2,2,2,0,2,2,2,9,2,2,2,0,2,2,2,0,2,2],
    [2,0,0,0,2,0,0,0,2,0,0,2,0,0,2,0,0,0,2,2],
    [2,2,2,0,2,2,2,0,2,2,2,0,2,2,2,0,2,2,2,2],
    [2,0,0,0,0,0,2,0,0,2,0,0,2,0,0,0,0,0,2,2],
    [2,0,2,2,2,0,2,2,2,0,2,2,2,0,2,2,2,0,2,2],
    [0,0,3,0,2,0,0,0,0,2,0,0,0,0,2,0,3,0,0,0],
    [5,2,2,2,2,2,2,0,4,2,4,0,2,2,2,2,2,2,2,5],
    [2,0,0,0,0,0,2,0,0,2,0,0,2,0,0,0,0,0,0,2],
    [2,2,2,0,2,2,3,0,2,2,2,0,3,2,2,0,2,2,2,2],
    [2,0,0,0,2,0,0,0,0,6,0,0,0,0,2,0,0,0,0,2],
    [2,0,2,2,2,0,5,2,2,2,2,2,5,0,2,2,2,0,2,2],
    [1,2,2,0,2,2,2,2,0,2,0,2,2,2,2,0,2,2,2,1]
  ],
  "locked": [
    { "roomA": "3-9", "roomB": "4-9" },
    { "roomA": "10-10", "roomB": "11-10" }
  ],
  "levers": [
    {
      "roomId": "2-9",
      "id": "GeloNorte",
      "doorRoomA": "3-9",
      "doorRoomB": "4-9"
    },
    {
      "roomId": "15-10",
      "id": "GeloSul",
      "doorRoomA": "10-10",
      "doorRoomB": "11-10"
    }
  ]
}
